,Away,Away_PTS,Home,Home_PTS,Margin,Away_SRS,Home_SRS
0,New Orleans Pelicans,122,Toronto Raptors,130,-8,0.3,5.88
1,Los Angeles Lakers,102,Los Angeles Clippers,112,-10,7.75,6.74
2,Chicago Bulls,125,Charlotte Hornets,126,-1,-3.81,-6.88
3,Detroit Pistons,119,Indiana Pacers,110,9,-4.22,1.61
4,Cleveland Cavaliers,85,Orlando Magic,94,-9,-7.57,-0.85
5,Minnesota Timberwolves,127,Brooklyn Nets,126,1,-3.78,-1.18
6,Memphis Grizzlies,101,Miami Heat,120,-19,-1.05,2.58
7,Boston Celtics,93,Philadelphia 76ers,107,-14,5.69,2.22
8,Washington Wizards,100,Dallas Mavericks,108,-8,-4.86,5.84
9,New York Knicks,111,San Antonio Spurs,120,-9,-6.55,-1.19
10,Oklahoma City Thunder,95,Utah Jazz,100,-5,2.79,3.2
11,Sacramento Kings,95,Phoenix Suns,124,-29,-1.44,-1.04
12,Denver Nuggets,108,Portland Trail Blazers,100,8,3.02,-1.11
13,Atlanta Hawks,117,Detroit Pistons,100,17,-7.57,-4.22
14,Milwaukee Bucks,117,Houston Rockets,111,6,10.44,3.78
15,Los Angeles Clippers,141,Golden State Warriors,122,19,6.74,-7.92
16,Toronto Raptors,106,Boston Celtics,112,-6,5.88,5.69
17,Minnesota Timberwolves,121,Charlotte Hornets,99,22,-3.78,-6.88
18,New York Knicks,109,Brooklyn Nets,113,-4,-6.55,-1.18
19,Chicago Bulls,110,Memphis Grizzlies,102,8,-3.81,-1.05
20,Dallas Mavericks,123,New Orleans Pelicans,116,7,5.84,0.3
21,Washington Wizards,97,Oklahoma City Thunder,85,12,-4.86,2.79
22,Phoenix Suns,107,Denver Nuggets,108,-1,-1.04,3.02
23,Portland Trail Blazers,122,Sacramento Kings,112,10,-1.11,-1.44
24,Utah Jazz,86,Los Angeles Lakers,95,-9,3.2,7.75
25,Miami Heat,131,Milwaukee Bucks,126,5,2.58,10.44
26,Philadelphia 76ers,117,Detroit Pistons,111,6,2.22,-4.22
27,Orlando Magic,99,Atlanta Hawks,103,-4,-0.85,-7.57
28,Boston Celtics,118,New York Knicks,95,23,5.69,-6.55
29,Toronto Raptors,108,Chicago Bulls,84,24,5.88,-3.81
30,Indiana Pacers,99,Cleveland Cavaliers,110,-11,1.61,-7.57
31,New Orleans Pelicans,123,Houston Rockets,126,-3,0.3,3.78
32,Washington Wizards,122,San Antonio Spurs,124,-2,-4.86,-1.19
33,Sacramento Kings,81,Utah Jazz,113,-32,-1.44,3.2
34,Los Angeles Clippers,122,Phoenix Suns,130,-8,6.74,-1.04
35,Golden State Warriors,92,Oklahoma City Thunder,120,-28,-7.92,2.79
36,Brooklyn Nets,133,Memphis Grizzlies,134,-1,-1.18,-1.05
37,Portland Trail Blazers,121,Dallas Mavericks,119,2,-1.11,5.84
38,Miami Heat,109,Minnesota Timberwolves,116,-7,2.58,-3.78
39,Charlotte Hornets,101,Los Angeles Lakers,120,-19,-6.88,7.75
40,Chicago Bulls,98,New York Knicks,105,-7,-3.81,-6.55
41,Indiana Pacers,94,Detroit Pistons,96,-2,1.61,-4.22
42,Orlando Magic,95,Toronto Raptors,104,-9,-0.85,5.88
43,Philadelphia 76ers,105,Atlanta Hawks,103,2,2.22,-7.57
44,Oklahoma City Thunder,112,Houston Rockets,116,-4,2.79,3.78
45,Cleveland Cavaliers,112,Milwaukee Bucks,129,-17,-7.57,10.44
46,Golden State Warriors,134,New Orleans Pelicans,123,11,-7.92,0.3
47,Portland Trail Blazers,110,San Antonio Spurs,113,-3,-1.11,-1.19
48,Utah Jazz,96,Phoenix Suns,95,1,3.2,-1.04
49,Denver Nuggets,101,Sacramento Kings,94,7,3.02,-1.44
50,Charlotte Hornets,96,Los Angeles Clippers,111,-15,-6.88,6.74
51,Atlanta Hawks,97,Miami Heat,112,-15,-7.57,2.58
52,Dallas Mavericks,109,Denver Nuggets,106,3,5.84,3.02
53,Memphis Grizzlies,91,Los Angeles Lakers,120,-29,-1.05,7.75
54,Chicago Bulls,111,Cleveland Cavaliers,117,-6,-3.81,-7.57
55,New York Knicks,83,Orlando Magic,95,-12,-6.55,-0.85
56,Minnesota Timberwolves,95,Philadelphia 76ers,117,-22,-3.78,2.22
57,Milwaukee Bucks,105,Boston Celtics,116,-11,10.44,5.69
58,Indiana Pacers,118,Brooklyn Nets,108,10,1.61,-1.18
59,Detroit Pistons,113,Toronto Raptors,125,-12,-4.22,5.88
60,Portland Trail Blazers,102,Oklahoma City Thunder,99,3,-1.11,2.79
61,Houston Rockets,159,Washington Wizards,158,1,3.78,-4.86
62,Charlotte Hornets,118,Sacramento Kings,111,7,-6.88,-1.44
63,Los Angeles Clippers,96,Utah Jazz,110,-14,6.74,3.2
64,Phoenix Suns,121,Golden State Warriors,110,11,-1.04,-7.92
65,Miami Heat,106,Atlanta Hawks,97,9,2.58,-7.57
66,Denver Nuggets,107,New Orleans Pelicans,122,-15,3.02,0.3
67,San Antonio Spurs,97,Los Angeles Clippers,103,-6,-1.19,6.74
0,Houston Rockets,116,Brooklyn Nets,123,-7,3.78,-1.18
1,Cleveland Cavaliers,95,Indiana Pacers,102,-7,-7.57,1.61
2,Milwaukee Bucks,123,Orlando Magic,91,32,10.44,-0.85
3,New York Knicks,102,Boston Celtics,104,-2,-6.55,5.69
4,Detroit Pistons,106,Chicago Bulls,112,-6,-4.22,-3.81
5,Los Angeles Lakers,119,Dallas Mavericks,110,9,7.75,5.84
6,Utah Jazz,101,Sacramento Kings,102,-1,3.2,-1.44
7,San Antonio Spurs,127,Golden State Warriors,110,17,-1.19,-7.92
8,New Orleans Pelicans,104,Oklahoma City Thunder,115,-11,0.3,2.79
9,Brooklyn Nets,109,Detroit Pistons,113,-4,-1.18,-4.22
10,Denver Nuggets,91,Orlando Magic,87,4,3.02,-0.85
11,Phoenix Suns,114,Memphis Grizzlies,105,9,-1.04,-1.05
12,Toronto Raptors,105,Milwaukee Bucks,115,-10,5.88,10.44
13,Minnesota Timberwolves,131,Washington Wizards,109,22,-3.78,-4.86
14,Charlotte Hornets,93,Golden State Warriors,87,6,-6.88,-7.92
15,Philadelphia 76ers,129,Portland Trail Blazers,128,1,2.22,-1.11
16,Chicago Bulls,95,Indiana Pacers,108,-13,-3.81,1.61
17,Houston Rockets,100,Miami Heat,129,-29,3.78,2.58
18,Sacramento Kings,113,New York Knicks,92,21,-1.44,-6.55
19,Los Angeles Lakers,103,San Antonio Spurs,96,7,7.75,-1.19
20,Dallas Mavericks,131,Cleveland Cavaliers,111,20,5.84,-7.57
21,Utah Jazz,94,Los Angeles Clippers,105,-11,3.2,6.74
22,Detroit Pistons,99,Washington Wizards,115,-16,-4.22,-4.86
23,New Orleans Pelicans,125,Brooklyn Nets,135,-10,0.3,-1.18
24,Houston Rockets,107,Memphis Grizzlies,100,7,3.78,-1.05
25,Milwaukee Bucks,134,Minnesota Timberwolves,106,28,10.44,-3.78
26,Philadelphia 76ers,109,Phoenix Suns,114,-5,2.22,-1.04
27,Portland Trail Blazers,118,Golden State Warriors,127,-9,-1.11,-7.92
28,Indiana Pacers,120,Charlotte Hornets,122,-2,1.61,-6.88
29,Boston Celtics,119,Cleveland Cavaliers,113,6,5.69,-7.57
30,San Antonio Spurs,100,Atlanta Hawks,108,-8,-1.19,-7.57
31,Los Angeles Lakers,118,Chicago Bulls,112,6,7.75,-3.81
32,Orlando Magic,94,Oklahoma City Thunder,102,-8,-0.85,2.79
33,Miami Heat,89,Denver Nuggets,109,-20,2.58,3.02
34,New York Knicks,102,Detroit Pistons,122,-20,-6.55,-4.22
35,Washington Wizards,106,Indiana Pacers,121,-15,-4.86,1.61
36,Chicago Bulls,113,Atlanta Hawks,93,20,-3.81,-7.57
37,Golden State Warriors,112,Houston Rockets,129,-17,-7.92,3.78
38,Sacramento Kings,120,Toronto Raptors,124,-4,-1.44,5.88
39,Minnesota Timberwolves,121,Memphis Grizzlies,137,-16,-3.78,-1.05
40,Orlando Magic,106,Dallas Mavericks,107,-1,-0.85,5.84
41,Philadelphia 76ers,104,Utah Jazz,106,-2,2.22,3.2
42,Milwaukee Bucks,129,Los Angeles Clippers,124,5,10.44,6.74
43,Boston Celtics,108,Charlotte Hornets,87,21,5.69,-6.88
44,Oklahoma City Thunder,112,San Antonio Spurs,121,-9,2.79,-1.19
45,Miami Heat,124,Phoenix Suns,108,16,2.58,-1.04
46,Portland Trail Blazers,101,Los Angeles Clippers,107,-6,-1.11,6.74
47,Detroit Pistons,106,Indiana Pacers,112,-6,-4.22,1.61
48,Memphis Grizzlies,86,Orlando Magic,118,-32,-1.05,-0.85
49,Cleveland Cavaliers,113,Washington Wizards,100,13,-7.57,-4.86
50,Sacramento Kings,121,Atlanta Hawks,109,12,-1.44,-7.57
51,Golden State Warriors,119,Minnesota Timberwolves,125,-6,-7.92,-3.78
52,Toronto Raptors,122,New Orleans Pelicans,104,18,5.88,0.3
53,New York Knicks,106,Dallas Mavericks,102,4,-6.55,5.84
54,Philadelphia 76ers,97,Denver Nuggets,100,-3,2.22,3.02
55,Milwaukee Bucks,100,Utah Jazz,103,-3,10.44,3.2
56,Brooklyn Nets,119,Portland Trail Blazers,115,4,-1.18,-1.11
57,Miami Heat,80,Los Angeles Lakers,95,-15,2.58,7.75
58,Boston Celtics,135,San Antonio Spurs,115,20,5.69,-1.19
59,New Orleans Pelicans,115,Charlotte Hornets,110,5,0.3,-6.88
60,Houston Rockets,117,Chicago Bulls,94,23,3.78,-3.81
61,Dallas Mavericks,138,Memphis Grizzlies,122,16,5.84,-1.05
62,Golden State Warriors,108,Oklahoma City Thunder,114,-6,-7.92,2.79
63,Denver Nuggets,100,Minnesota Timberwolves,98,2,3.02,-3.78
64,Indiana Pacers,109,Orlando Magic,102,7,1.61,-0.85
65,Charlotte Hornets,106,Philadelphia 76ers,114,-8,-6.88,2.22
66,Milwaukee Bucks,121,Oklahoma City Thunder,119,2,10.44,2.79
67,Cleveland Cavaliers,108,New York Knicks,87,21,-7.57,-6.55
68,Brooklyn Nets,112,Phoenix Suns,138,-26,-1.18,-1.04
69,Atlanta Hawks,113,Portland Trail Blazers,124,-11,-7.57,-1.11
70,Toronto Raptors,113,Los Angeles Lakers,104,9,5.88,7.75
71,Minnesota Timberwolves,120,Detroit Pistons,114,6,-3.78,-4.22
72,Dallas Mavericks,106,Boston Celtics,116,-10,5.84,5.69
73,Memphis Grizzlies,113,San Antonio Spurs,109,4,-1.05,-1.19
74,Houston Rockets,122,New Orleans Pelicans,116,6,3.78,0.3
75,Utah Jazz,122,Golden State Warriors,108,14,3.2,-7.92
76,Toronto Raptors,88,Los Angeles Clippers,98,-10,5.88,6.74
77,Oklahoma City Thunder,85,Indiana Pacers,111,-26,2.79,1.61
78,Cleveland Cavaliers,97,Philadelphia 76ers,98,-1,-7.57,2.22
79,Detroit Pistons,108,Miami Heat,117,-9,-4.22,2.58
80,New York Knicks,102,Chicago Bulls,120,-18,-6.55,-3.81
81,Atlanta Hawks,125,Denver Nuggets,121,4,-7.57,3.02
82,Los Angeles Lakers,123,Phoenix Suns,115,8,7.75,-1.04
83,Brooklyn Nets,114,Utah Jazz,119,-5,-1.18,3.2
84,Portland Trail Blazers,99,Sacramento Kings,107,-8,-1.11,-1.44
85,Memphis Grizzlies,119,Charlotte Hornets,117,2,-1.05,-6.88
86,Philadelphia 76ers,97,Orlando Magic,112,-15,2.22,-0.85
87,Washington Wizards,133,Boston Celtics,140,-7,-4.86,5.69
88,Los Angeles Clippers,93,Houston Rockets,102,-9,6.74,3.78
89,San Antonio Spurs,114,Minnesota Timberwolves,129,-15,-1.19,-3.78
90,Golden State Warriors,94,Los Angeles Lakers,120,-26,-7.92,7.75
91,Toronto Raptors,114,Portland Trail Blazers,106,8,5.88,-1.11
92,Miami Heat,108,Cleveland Cavaliers,97,11,2.58,-7.57
93,Chicago Bulls,115,Milwaukee Bucks,124,-9,-3.81,10.44
94,Los Angeles Clippers,127,New Orleans Pelicans,132,-5,6.74,0.3
95,Dallas Mavericks,103,New York Knicks,106,-3,5.84,-6.55
96,Atlanta Hawks,112,Phoenix Suns,128,-16,-7.57,-1.04
97,Brooklyn Nets,93,Denver Nuggets,101,-8,-1.18,3.02
98,Detroit Pistons,106,Charlotte Hornets,109,-3,-4.22,-6.88
99,San Antonio Spurs,109,Orlando Magic,111,-2,-1.19,-0.85
100,Indiana Pacers,102,Houston Rockets,111,-9,1.61,3.78
101,Utah Jazz,106,Memphis Grizzlies,107,-1,3.2,-1.05
102,Washington Wizards,137,Minnesota Timberwolves,116,21,-4.86,-3.78
103,Philadelphia 76ers,119,Oklahoma City Thunder,127,-8,2.22,2.79
104,Boston Celtics,105,Golden State Warriors,100,5,5.69,-7.92
105,Sacramento Kings,97,Los Angeles Lakers,99,-2,-1.44,7.75
106,Brooklyn Nets,117,Chicago Bulls,111,6,-1.18,-3.81
107,Milwaukee Bucks,102,Indiana Pacers,83,19,10.44,1.61
108,Charlotte Hornets,103,New York Knicks,102,1,-6.88,-6.55
109,New Orleans Pelicans,94,Miami Heat,109,-15,0.3,2.58
110,Houston Rockets,125,Minnesota Timberwolves,105,20,3.78,-3.78
111,Toronto Raptors,102,Dallas Mavericks,110,-8,5.88,5.84
112,Portland Trail Blazers,121,San Antonio Spurs,116,5,-1.11,-1.19
113,Atlanta Hawks,101,Los Angeles Clippers,150,-49,-7.57,6.74
114,Philadelphia 76ers,114,Cleveland Cavaliers,95,19,2.22,-7.57
115,Boston Celtics,99,Sacramento Kings,100,-1,5.69,-1.44
116,Denver Nuggets,131,Memphis Grizzlies,114,17,3.02,-1.05
117,Washington Wizards,121,Orlando Magic,125,-4,-4.86,-0.85
118,Golden State Warriors,100,New Orleans Pelicans,108,-8,-7.92,0.3
119,Atlanta Hawks,101,Los Angeles Lakers,122,-21,-7.57,7.75
120,Cleveland Cavaliers,105,New York Knicks,123,-18,-7.57,-6.55
121,Indiana Pacers,115,Brooklyn Nets,86,29,1.61,-1.18
122,Charlotte Hornets,96,Toronto Raptors,132,-36,-6.88,5.88
123,Milwaukee Bucks,115,Chicago Bulls,101,14,10.44,-3.81
124,Portland Trail Blazers,108,Houston Rockets,132,-24,-1.11,3.78
125,San Antonio Spurs,110,Dallas Mavericks,117,-7,-1.19,5.84
126,Boston Celtics,99,Phoenix Suns,85,14,5.69,-1.04
127,Minnesota Timberwolves,112,Utah Jazz,102,10,-3.78,3.2
128,Oklahoma City Thunder,88,Los Angeles Clippers,90,-2,2.79,6.74
129,Golden State Warriors,114,Memphis Grizzlies,95,19,-7.92,-1.05
130,Portland Trail Blazers,104,New Orleans Pelicans,115,-11,-1.11,0.3
131,Phoenix Suns,116,Sacramento Kings,120,-4,-1.04,-1.44
132,Oklahoma City Thunder,107,Los Angeles Lakers,112,-5,2.79,7.75
133,New York Knicks,104,Philadelphia 76ers,109,-5,-6.55,2.22
134,San Antonio Spurs,132,Washington Wizards,138,-6,-1.19,-4.86
135,Milwaukee Bucks,135,Atlanta Hawks,127,8,10.44,-7.57
136,Charlotte Hornets,91,Brooklyn Nets,101,-10,-6.88,-1.18
137,Golden State Warriors,94,Dallas Mavericks,142,-48,-7.92,5.84
138,Cleveland Cavaliers,100,Miami Heat,124,-24,-7.57,2.58
139,Orlando Magic,97,Toronto Raptors,113,-16,-0.85,5.88
140,Detroit Pistons,89,Chicago Bulls,109,-20,-4.22,-3.81
141,Utah Jazz,103,Minnesota Timberwolves,95,8,3.2,-3.78
142,Houston Rockets,95,Denver Nuggets,105,-10,3.78,3.02
143,Boston Celtics,104,Los Angeles Clippers,107,-3,5.69,6.74
144,Portland Trail Blazers,129,Milwaukee Bucks,137,-8,-1.11,10.44
145,New Orleans Pelicans,124,Phoenix Suns,121,3,0.3,-1.04
146,Atlanta Hawks,103,Detroit Pistons,128,-25,-7.57,-4.22
147,Charlotte Hornets,118,Washington Wizards,125,-7,-6.88,-4.86
148,Sacramento Kings,97,Brooklyn Nets,116,-19,-1.44,-1.18
149,Miami Heat,116,Chicago Bulls,108,8,2.58,-3.81
150,Los Angeles Lakers,130,Oklahoma City Thunder,127,3,7.75,2.79
151,San Antonio Spurs,104,Philadelphia 76ers,115,-11,-1.19,2.22
152,Cleveland Cavaliers,101,Dallas Mavericks,143,-42,-7.57,5.84
153,Boston Celtics,92,Denver Nuggets,96,-4,5.69,3.02
154,Golden State Warriors,109,Utah Jazz,113,-4,-7.92,3.2
155,Houston Rockets,119,Los Angeles Clippers,122,-3,3.78,6.74
156,Phoenix Suns,100,Minnesota Timberwolves,98,2,-1.04,-3.78
157,Chicago Bulls,116,Charlotte Hornets,115,1,-3.81,-6.88
158,Orlando Magic,106,Indiana Pacers,111,-5,-0.85,1.61
159,Toronto Raptors,119,Atlanta Hawks,116,3,5.88,-7.57
160,San Antonio Spurs,111,New York Knicks,104,7,-1.19,-6.55
161,Miami Heat,86,Philadelphia 76ers,113,-27,2.58,2.22
162,Portland Trail Blazers,104,Cleveland Cavaliers,110,-6,-1.11,-7.57
163,Los Angeles Lakers,109,Memphis Grizzlies,108,1,7.75,-1.05
164,Detroit Pistons,90,Milwaukee Bucks,104,-14,-4.22,10.44
165,New Orleans Pelicans,120,Utah Jazz,128,-8,0.3,3.2
166,Dallas Mavericks,137,Houston Rockets,123,14,5.84,3.78
167,Brooklyn Nets,103,New York Knicks,101,2,-1.18,-6.55
168,Sacramento Kings,113,Washington Wizards,106,7,-1.44,-4.86
169,Phoenix Suns,104,Denver Nuggets,116,-12,-1.04,3.02
170,New Orleans Pelicans,109,Los Angeles Clippers,134,-25,0.3,6.74
171,Brooklyn Nets,108,Cleveland Cavaliers,106,2,-1.18,-7.57
172,Orlando Magic,88,Detroit Pistons,103,-15,-0.85,-4.22
173,Memphis Grizzlies,114,Indiana Pacers,126,-12,-1.05,1.61
174,Minnesota Timberwolves,125,Atlanta Hawks,113,12,-3.78,-7.57
175,Sacramento Kings,102,Boston Celtics,103,-1,-1.44,5.69
176,Charlotte Hornets,100,Miami Heat,117,-17,-6.88,2.58
177,Philadelphia 76ers,96,Toronto Raptors,101,-5,2.22,5.88
178,Portland Trail Blazers,117,Chicago Bulls,94,23,-1.11,-3.81
179,Utah Jazz,118,Milwaukee Bucks,122,-4,3.2,10.44
180,Los Angeles Lakers,114,San Antonio Spurs,104,10,7.75,-1.19
181,Oklahoma City Thunder,100,Golden State Warriors,97,3,2.79,-7.92
182,Los Angeles Clippers,114,Dallas Mavericks,99,15,6.74,5.84
183,Washington Wizards,104,Denver Nuggets,117,-13,-4.86,3.02
184,Brooklyn Nets,110,Boston Celtics,121,-11,-1.18,5.69
185,Detroit Pistons,101,Charlotte Hornets,102,-1,-4.22,-6.88
186,Orlando Magic,116,Cleveland Cavaliers,104,12,-0.85,-7.57
187,Utah Jazz,102,Indiana Pacers,121,-19,3.2,1.61
188,Sacramento Kings,91,Philadelphia 76ers,97,-6,-1.44,2.22
189,New York Knicks,98,Toronto Raptors,126,-28,-6.55,5.88
190,Miami Heat,108,Houston Rockets,117,-9,2.58,3.78
191,Los Angeles Clippers,121,Memphis Grizzlies,119,2,6.74,-1.05
192,Atlanta Hawks,102,Milwaukee Bucks,111,-9,-7.57,10.44
193,Minnesota Timberwolves,113,San Antonio Spurs,101,12,-3.78,-1.19
194,Washington Wizards,140,Phoenix Suns,132,8,-4.86,-1.04
195,Los Angeles Lakers,114,New Orleans Pelicans,110,4,7.75,0.3
196,Oklahoma City Thunder,119,Portland Trail Blazers,136,-17,2.79,-1.11
197,Chicago Bulls,90,Golden State Warriors,104,-14,-3.81,-7.92
198,Boston Celtics,107,Brooklyn Nets,112,-5,5.69,-1.18
199,Charlotte Hornets,110,Detroit Pistons,107,3,-6.88,-4.22
200,Toronto Raptors,90,Orlando Magic,83,7,5.88,-0.85
201,Milwaukee Bucks,119,Cleveland Cavaliers,110,9,10.44,-7.57
202,Philadelphia 76ers,101,New York Knicks,95,6,2.22,-6.55
203,Atlanta Hawks,104,Indiana Pacers,105,-1,-7.57,1.61
204,Utah Jazz,103,Memphis Grizzlies,94,9,3.2,-1.05
205,Golden State Warriors,105,Miami Heat,122,-17,-7.92,2.58
206,New Orleans Pelicans,104,Oklahoma City Thunder,109,-5,0.3,2.79
207,Los Angeles Clippers,97,San Antonio Spurs,107,-10,6.74,-1.19
208,Dallas Mavericks,120,Phoenix Suns,113,7,5.84,-1.04
209,Chicago Bulls,103,Portland Trail Blazers,107,-4,-3.81,-1.11
210,Washington Wizards,103,Los Angeles Lakers,125,-22,-4.86,7.75
211,Denver Nuggets,97,Sacramento Kings,100,-3,3.02,-1.44
212,Indiana Pacers,116,Philadelphia 76ers,119,-3,1.61,2.22
213,Atlanta Hawks,111,Houston Rockets,158,-47,-7.57,3.78
214,Charlotte Hornets,96,Milwaukee Bucks,137,-41,-6.88,10.44
0,Miami Heat,109,Brooklyn Nets,106,3,2.58,-1.18
1,Memphis Grizzlies,115,Minnesota Timberwolves,107,8,-1.05,-3.78
2,Boston Celtics,113,New York Knicks,104,9,5.69,-6.55
3,Dallas Mavericks,114,Los Angeles Lakers,100,14,5.84,7.75
4,San Antonio Spurs,98,Detroit Pistons,132,-34,-1.19,-4.22
5,Oklahoma City Thunder,107,New Orleans Pelicans,104,3,2.79,0.3
6,Golden State Warriors,96,Orlando Magic,100,-4,-7.92,-0.85
7,Utah Jazz,110,Toronto Raptors,130,-20,3.2,5.88
8,Washington Wizards,125,Los Angeles Clippers,150,-25,-4.86,6.74
9,Phoenix Suns,109,Charlotte Hornets,104,5,-1.04,-6.88
10,Utah Jazz,94,Philadelphia 76ers,103,-9,3.2,2.22
11,Golden State Warriors,79,Atlanta Hawks,104,-25,-7.92,-7.57
12,Indiana Pacers,117,Memphis Grizzlies,104,13,1.61,-1.05
13,New York Knicks,88,Milwaukee Bucks,132,-44,-6.55,10.44
14,Chicago Bulls,113,Sacramento Kings,106,7,-3.81,-1.44
15,Detroit Pistons,127,Cleveland Cavaliers,94,33,-4.22,-7.57
16,Orlando Magic,127,Washington Wizards,120,7,-0.85,-4.86
17,Dallas Mavericks,118,New Orleans Pelicans,97,21,5.84,0.3
18,Miami Heat,121,Toronto Raptors,110,11,2.58,5.88
19,Houston Rockets,133,San Antonio Spurs,135,-2,3.78,-1.19
20,Los Angeles Lakers,105,Denver Nuggets,96,9,7.75,3.02
21,Portland Trail Blazers,97,Los Angeles Clippers,117,-20,-1.11,6.74
22,Golden State Warriors,91,Charlotte Hornets,106,-15,-7.92,-6.88
23,Milwaukee Bucks,127,Detroit Pistons,103,24,10.44,-4.22
24,Phoenix Suns,114,Orlando Magic,128,-14,-1.04,-0.85
25,Brooklyn Nets,130,Atlanta Hawks,118,12,-1.18,-7.57
26,Miami Heat,93,Boston Celtics,112,-19,2.58,5.69
27,Memphis Grizzlies,99,Chicago Bulls,106,-7,-1.05,-3.81
28,Indiana Pacers,107,Oklahoma City Thunder,100,7,1.61,2.79
29,Minnesota Timberwolves,114,Dallas Mavericks,121,-7,-3.78,5.84
30,Los Angeles Lakers,121,Utah Jazz,96,25,7.75,3.2
31,Sacramento Kings,116,Portland Trail Blazers,127,-11,-1.44,-1.11
32,Philadelphia 76ers,113,Washington Wizards,119,-6,2.22,-4.86
33,Denver Nuggets,129,New York Knicks,92,37,3.02,-6.55
34,Houston Rockets,119,Toronto Raptors,109,10,3.78,5.88
35,Phoenix Suns,139,New Orleans Pelicans,132,7,-1.04,0.3
36,Brooklyn Nets,111,Charlotte Hornets,104,7,-1.18,-6.88
37,Orlando Magic,93,Cleveland Cavaliers,87,6,-0.85,-7.57
38,Indiana Pacers,101,Detroit Pistons,108,-7,1.61,-4.22
39,Denver Nuggets,95,Boston Celtics,108,-13,3.02,5.69
40,Golden State Warriors,100,Chicago Bulls,98,2,-7.92,-3.81
41,Washington Wizards,103,Miami Heat,112,-9,-4.86,2.58
42,Minnesota Timberwolves,127,Oklahoma City Thunder,139,-12,-3.78,2.79
43,Los Angeles Clippers,91,Milwaukee Bucks,119,-28,6.74,10.44
44,Sacramento Kings,104,San Antonio Spurs,105,-1,-1.44,-1.19
45,Los Angeles Lakers,136,Portland Trail Blazers,113,23,7.75,-1.11
46,New Orleans Pelicans,84,Dallas Mavericks,130,-46,0.3,5.84
47,Indiana Pacers,104,New York Knicks,103,1,1.61,-6.55
48,Cleveland Cavaliers,94,Philadelphia 76ers,141,-47,-7.57,2.22
49,Phoenix Suns,109,Houston Rockets,115,-6,-1.04,3.78
50,Memphis Grizzlies,112,Utah Jazz,126,-14,-1.05,3.2
51,Denver Nuggets,102,Brooklyn Nets,105,-3,3.02,-1.18
52,Atlanta Hawks,122,Charlotte Hornets,107,15,-7.57,-6.88
53,Chicago Bulls,105,Miami Heat,110,-5,-3.81,2.58
54,Toronto Raptors,104,Philadelphia 76ers,110,-6,5.88,2.22
55,Los Angeles Clippers,135,Washington Wizards,119,16,6.74,-4.86
56,Sacramento Kings,110,Dallas Mavericks,106,4,-1.44,5.84
57,Oklahoma City Thunder,108,Portland Trail Blazers,96,12,2.79,-1.11
58,Minnesota Timberwolves,125,Los Angeles Lakers,142,-17,-3.78,7.75
59,Los Angeles Clippers,110,Indiana Pacers,99,11,6.74,1.61
60,Cleveland Cavaliers,88,Boston Celtics,110,-22,-7.57,5.69
61,Toronto Raptors,93,Chicago Bulls,92,1,5.88,-3.81
62,Sacramento Kings,119,Houston Rockets,118,1,-1.44,3.78
63,Orlando Magic,101,Milwaukee Bucks,110,-9,-0.85,10.44
64,Detroit Pistons,105,New Orleans Pelicans,103,2,-4.22,0.3
65,Minnesota Timberwolves,109,Phoenix Suns,125,-16,-3.78,-1.04
66,Oklahoma City Thunder,104,Utah Jazz,90,14,2.79,3.2
67,Memphis Grizzlies,110,Golden State Warriors,102,8,-1.05,-7.92
68,Washington Wizards,107,Charlotte Hornets,114,-7,-4.86,-6.88
69,Atlanta Hawks,121,Miami Heat,135,-14,-7.57,2.58
70,Denver Nuggets,92,Philadelphia 76ers,97,-5,3.02,2.22
71,New York Knicks,87,Portland Trail Blazers,115,-28,-6.55,-1.11
72,Houston Rockets,116,Cleveland Cavaliers,110,6,3.78,-7.57
73,Boston Celtics,117,Indiana Pacers,122,-5,5.69,1.61
74,Los Angeles Lakers,96,Orlando Magic,87,9,7.75,-0.85
75,Los Angeles Clippers,112,Toronto Raptors,92,20,6.74,5.88
76,Charlotte Hornets,113,Brooklyn Nets,108,5,-6.88,-1.18
77,Atlanta Hawks,102,Chicago Bulls,136,-34,-7.57,-3.81
78,Utah Jazz,127,Minnesota Timberwolves,116,11,3.2,-3.78
79,Memphis Grizzlies,115,Phoenix Suns,108,7,-1.05,-1.04
80,New Orleans Pelicans,112,Milwaukee Bucks,127,-15,0.3,10.44
81,Oklahoma City Thunder,93,Sacramento Kings,94,-1,2.79,-1.44
82,New York Knicks,124,Golden State Warriors,122,2,-6.55,-7.92
83,Philadelphia 76ers,115,Boston Celtics,109,6,2.22,5.69
84,Cleveland Cavaliers,117,San Antonio Spurs,109,8,-7.57,-1.19
85,Dallas Mavericks,122,Detroit Pistons,111,11,5.84,-4.22
86,Portland Trail Blazers,99,Denver Nuggets,114,-15,-1.11,3.02
87,Los Angeles Lakers,113,Miami Heat,110,3,7.75,2.58
88,Houston Rockets,130,Orlando Magic,107,23,3.78,-0.85
89,New Orleans Pelicans,109,Philadelphia 76ers,116,-7,0.3,2.22
90,Indiana Pacers,110,Atlanta Hawks,100,10,1.61,-7.57
91,Charlotte Hornets,83,Chicago Bulls,73,10,-6.88,-3.81
92,Milwaukee Bucks,127,Memphis Grizzlies,114,13,10.44,-1.05
93,Golden State Warriors,106,Utah Jazz,114,-8,-7.92,3.2
94,Los Angeles Clippers,124,Minnesota Timberwolves,117,7,6.74,-3.78
95,New York Knicks,103,Sacramento Kings,101,2,-6.55,-1.44
96,San Antonio Spurs,121,Phoenix Suns,119,2,-1.19,-1.04
97,Brooklyn Nets,102,Toronto Raptors,110,-8,-1.18,5.88
98,Los Angeles Clippers,106,Chicago Bulls,109,-3,6.74,-3.81
99,Washington Wizards,111,Memphis Grizzlies,128,-17,-4.86,-1.05
100,Miami Heat,122,Dallas Mavericks,118,4,2.58,5.84
101,Cleveland Cavaliers,108,Milwaukee Bucks,125,-17,-7.57,10.44
102,Oklahoma City Thunder,102,Denver Nuggets,110,-8,2.79,3.02
103,Detroit Pistons,115,Houston Rockets,107,8,-4.22,3.78
104,Orlando Magic,130,New Orleans Pelicans,119,11,-0.85,0.3
105,Charlotte Hornets,85,Indiana Pacers,107,-22,-6.88,1.61
106,Los Angeles Lakers,101,Atlanta Hawks,96,5,7.75,-7.57
107,Philadelphia 76ers,89,Brooklyn Nets,109,-20,2.22,-1.18
108,New York Knicks,105,Denver Nuggets,111,-6,-6.55,3.02
109,Sacramento Kings,100,Golden State Warriors,79,21,-1.44,-7.92
110,Washington Wizards,133,Detroit Pistons,119,14,-4.86,-4.22
111,Cleveland Cavaliers,113,Toronto Raptors,133,-20,-7.57,5.88
112,San Antonio Spurs,107,Houston Rockets,109,-2,-1.19,3.78
113,Miami Heat,111,Memphis Grizzlies,118,-7,2.58,-1.05
114,Dallas Mavericks,120,Milwaukee Bucks,116,4,5.84,10.44
115,Chicago Bulls,106,Oklahoma City Thunder,109,-3,-3.81,2.79
116,Portland Trail Blazers,111,Phoenix Suns,110,1,-1.11,-1.04
117,Sacramento Kings,102,Charlotte Hornets,110,-8,-1.44,-6.88
118,Los Angeles Lakers,102,Indiana Pacers,105,-3,7.75,1.61
119,Atlanta Hawks,120,New York Knicks,143,-23,-7.57,-6.55
120,Brooklyn Nets,108,New Orleans Pelicans,101,7,-1.18,0.3
121,Orlando Magic,102,Utah Jazz,109,-7,-0.85,3.2
122,Phoenix Suns,99,Los Angeles Clippers,120,-21,-1.04,6.74
123,Charlotte Hornets,98,Cleveland Cavaliers,100,-2,-6.88,-7.57
124,Toronto Raptors,112,Detroit Pistons,99,13,5.88,-4.22
125,Miami Heat,108,Philadelphia 76ers,104,4,2.58,2.22
126,Chicago Bulls,110,Washington Wizards,109,1,-3.81,-4.86
127,New Orleans Pelicans,107,Minnesota Timberwolves,99,8,0.3,-3.78
128,Memphis Grizzlies,122,Oklahoma City Thunder,126,-4,-1.05,2.79
129,Orlando Magic,104,Denver Nuggets,113,-9,-0.85,3.02
130,Boston Celtics,109,Dallas Mavericks,103,6,5.69,5.84
131,Golden State Warriors,112,Portland Trail Blazers,122,-10,-7.92,-1.11
132,Utah Jazz,111,Atlanta Hawks,106,5,3.2,-7.57
133,Los Angeles Lakers,104,Milwaukee Bucks,111,-7,7.75,10.44
134,Brooklyn Nets,105,San Antonio Spurs,118,-13,-1.18,-1.19
135,Houston Rockets,122,Los Angeles Clippers,117,5,3.78,6.74
136,Memphis Grizzlies,107,Cleveland Cavaliers,114,-7,-1.05,-7.57
137,Sacramento Kings,105,Indiana Pacers,119,-14,-1.44,1.61
138,Detroit Pistons,93,Boston Celtics,114,-21,-4.22,5.69
139,Washington Wizards,118,Toronto Raptors,122,-4,-4.86,5.88
140,New York Knicks,114,Miami Heat,129,-15,-6.55,2.58
141,Phoenix Suns,108,Oklahoma City Thunder,126,-18,-1.04,2.79
142,Dallas Mavericks,117,Philadelphia 76ers,98,19,5.84,2.22
143,Minnesota Timberwolves,100,Denver Nuggets,109,-9,-3.78,3.02
144,Orlando Magic,103,Portland Trail Blazers,118,-15,-0.85,-1.11
145,New Orleans Pelicans,102,Golden State Warriors,106,-4,0.3,-7.92
146,Utah Jazz,114,Charlotte Hornets,107,7,3.2,-6.88
147,Atlanta Hawks,112,Brooklyn Nets,122,-10,-7.57,-1.18
148,Chicago Bulls,119,Detroit Pistons,107,12,-3.81,-4.22
149,Washington Wizards,108,Philadelphia 76ers,125,-17,-4.86,2.22
150,Milwaukee Bucks,123,New York Knicks,102,21,10.44,-6.55
151,Sacramento Kings,115,Memphis Grizzlies,119,-4,-1.44,-1.05
152,Los Angeles Clippers,134,San Antonio Spurs,109,25,6.74,-1.19
153,Houston Rockets,139,Phoenix Suns,125,14,3.78,-1.04
154,Minnesota Timberwolves,106,Portland Trail Blazers,113,-7,-3.78,-1.11
155,Dallas Mavericks,107,Toronto Raptors,110,-3,5.84,5.88
156,Charlotte Hornets,93,Boston Celtics,119,-26,-6.88,5.69
157,Indiana Pacers,89,Milwaukee Bucks,117,-28,1.61,10.44
158,Los Angeles Clippers,112,Oklahoma City Thunder,118,-6,6.74,2.79
159,Denver Nuggets,128,Los Angeles Lakers,104,24,3.02,7.75
160,Atlanta Hawks,118,Cleveland Cavaliers,121,-3,-7.57,-7.57
161,Philadelphia 76ers,125,Detroit Pistons,109,16,2.22,-4.22
162,Toronto Raptors,115,Indiana Pacers,120,-5,5.88,1.61
163,Washington Wizards,121,New York Knicks,115,6,-4.86,-6.55
164,Chicago Bulls,95,Orlando Magic,103,-8,-3.81,-0.85
165,Utah Jazz,104,Miami Heat,107,-3,3.2,2.58
166,San Antonio Spurs,145,Memphis Grizzlies,115,30,-1.19,-1.05
167,Denver Nuggets,113,Phoenix Suns,111,2,3.02,-1.04
168,New Orleans Pelicans,102,Portland Trail Blazers,94,8,0.3,-1.11
169,Houston Rockets,113,Sacramento Kings,104,9,3.78,-1.44
170,Minnesota Timberwolves,104,Golden State Warriors,113,-9,-3.78,-7.92
171,Boston Celtics,118,Toronto Raptors,102,16,5.69,5.88
172,Milwaukee Bucks,109,Philadelphia 76ers,121,-12,10.44,2.22
173,Houston Rockets,104,Golden State Warriors,116,-12,3.78,-7.92
174,Los Angeles Clippers,111,Los Angeles Lakers,106,5,6.74,7.75
175,New Orleans Pelicans,112,Denver Nuggets,100,12,0.3,3.02
176,Washington Wizards,102,Detroit Pistons,132,-30,-4.86,-4.22
177,New York Knicks,94,Brooklyn Nets,82,12,-6.55,-1.18
178,San Antonio Spurs,98,Dallas Mavericks,102,-4,-1.19,5.84
179,Memphis Grizzlies,110,Oklahoma City Thunder,97,13,-1.05,2.79
180,Minnesota Timberwolves,105,Sacramento Kings,104,1,-3.78,-1.44
181,Portland Trail Blazers,115,Utah Jazz,121,-6,-1.11,3.2
182,Cleveland Cavaliers,117,Boston Celtics,129,-12,-7.57,5.69
183,Oklahoma City Thunder,104,Charlotte Hornets,102,2,2.79,-6.88
184,Philadelphia 76ers,97,Orlando Magic,98,-1,2.22,-0.85
185,Milwaukee Bucks,112,Atlanta Hawks,86,26,10.44,-7.57
186,Indiana Pacers,112,Miami Heat,113,-1,1.61,2.58
187,Phoenix Suns,96,Golden State Warriors,105,-9,-1.04,-7.92
188,Memphis Grizzlies,110,Denver Nuggets,119,-9,-1.05,3.02
189,Toronto Raptors,113,Boston Celtics,97,16,5.88,5.69
190,Indiana Pacers,98,New Orleans Pelicans,120,-22,1.61,0.3
191,Atlanta Hawks,81,Chicago Bulls,116,-35,-7.57,-3.81
192,Brooklyn Nets,98,Houston Rockets,108,-10,-1.18,3.78
193,Philadelphia 76ers,116,Miami Heat,117,-1,2.22,2.58
194,Cleveland Cavaliers,94,Minnesota Timberwolves,88,6,-7.57,-3.78
195,New York Knicks,107,Washington Wizards,100,7,-6.55,-4.86
196,Dallas Mavericks,141,Golden State Warriors,121,20,5.84,-7.92
197,Orlando Magic,100,Milwaukee Bucks,111,-11,-0.85,10.44
198,Detroit Pistons,109,San Antonio Spurs,136,-27,-4.22,-1.19
199,Phoenix Suns,112,Sacramento Kings,110,2,-1.04,-1.44
200,Los Angeles Lakers,128,Portland Trail Blazers,120,8,7.75,-1.11
201,Utah Jazz,120,Los Angeles Clippers,107,13,3.2,6.74
202,Oklahoma City Thunder,98,Toronto Raptors,97,1,2.79,5.88
203,Sacramento Kings,115,Denver Nuggets,120,-5,-1.44,3.02
204,Charlotte Hornets,104,Memphis Grizzlies,117,-13,-6.88,-1.05
205,Houston Rockets,112,New Orleans Pelicans,127,-15,3.78,0.3
206,Dallas Mavericks,95,Los Angeles Lakers,108,-13,5.84,7.75
207,Atlanta Hawks,101,Orlando Magic,93,8,-7.57,-0.85
208,Miami Heat,105,Washington Wizards,123,-18,2.58,-4.86
209,Milwaukee Bucks,123,Chicago Bulls,102,21,10.44,-3.81
210,Brooklyn Nets,115,Minnesota Timberwolves,122,-7,-1.18,-3.78
211,Detroit Pistons,81,Utah Jazz,104,-23,-4.22,3.2
212,Phoenix Suns,122,Portland Trail Blazers,116,6,-1.04,-1.11
213,Boston Celtics,109,Charlotte Hornets,92,17,5.69,-6.88
214,Philadelphia 76ers,97,Indiana Pacers,115,-18,2.22,1.61
215,Los Angeles Clippers,105,Sacramento Kings,87,18,6.74,-1.44
216,Denver Nuggets,104,Houston Rockets,130,-26,3.02,3.78
217,Golden State Warriors,113,San Antonio Spurs,117,-4,-7.92,-1.19
218,Cleveland Cavaliers,97,Toronto Raptors,117,-20,-7.57,5.88
219,Dallas Mavericks,101,Oklahoma City Thunder,106,-5,5.84,2.79
0,Orlando Magic,122,Washington Wizards,101,21,-0.85,-4.86
1,Portland Trail Blazers,93,New York Knicks,117,-24,-1.11,-6.55
2,Minnesota Timberwolves,104,Milwaukee Bucks,106,-2,-3.78,10.44
3,Phoenix Suns,107,Los Angeles Lakers,117,-10,-1.04,7.75
4,Charlotte Hornets,109,Cleveland Cavaliers,106,3,-6.88,-7.57
5,Denver Nuggets,124,Indiana Pacers,116,8,3.02,1.61
6,Toronto Raptors,76,Miami Heat,84,-8,5.88,2.58
7,Utah Jazz,102,Chicago Bulls,98,4,3.2,-3.81
8,Golden State Warriors,84,Minnesota Timberwolves,99,-15,-7.92,-3.78
9,Brooklyn Nets,111,Dallas Mavericks,123,-12,-1.18,5.84
10,Oklahoma City Thunder,109,San Antonio Spurs,103,6,2.79,-1.19
11,Memphis Grizzlies,123,Sacramento Kings,128,-5,-1.05,-1.44
12,Detroit Pistons,112,Los Angeles Clippers,126,-14,-4.22,6.74
13,Atlanta Hawks,106,Boston Celtics,109,-3,-7.57,5.69
14,Miami Heat,85,Orlando Magic,105,-20,2.58,-0.85
15,Portland Trail Blazers,122,Washington Wizards,103,19,-1.11,-4.86
16,Philadelphia 76ers,108,Houston Rockets,118,-10,2.22,3.78
17,New York Knicks,112,Phoenix Suns,120,-8,-6.55,-1.04
18,New Orleans Pelicans,113,Los Angeles Lakers,123,-10,0.3,7.75
19,Memphis Grizzlies,140,Los Angeles Clippers,114,26,-1.05,6.74
20,Toronto Raptors,121,Brooklyn Nets,102,19,5.88,-1.18
21,Utah Jazz,109,Orlando Magic,96,13,3.2,-0.85
22,Indiana Pacers,111,Atlanta Hawks,116,-5,1.61,-7.57
23,Oklahoma City Thunder,121,Cleveland Cavaliers,106,15,2.79,-7.57
24,Boston Celtics,111,Chicago Bulls,104,7,5.69,-3.81
25,Denver Nuggets,114,Washington Wizards,128,-14,3.02,-4.86
26,Charlotte Hornets,123,Dallas Mavericks,120,3,-6.88,5.84
27,Detroit Pistons,111,Golden State Warriors,104,7,-4.22,-7.92
28,San Antonio Spurs,118,Milwaukee Bucks,127,-9,-1.19,10.44
29,New Orleans Pelicans,117,Sacramento Kings,115,2,0.3,-1.44
30,New York Knicks,132,Los Angeles Clippers,135,-3,-6.55,6.74
31,Portland Trail Blazers,111,Miami Heat,122,-11,-1.11,2.58
32,Minnesota Timberwolves,118,Cleveland Cavaliers,103,15,-3.78,-7.57
33,Memphis Grizzlies,121,Phoenix Suns,114,7,-1.05,-1.04
34,Detroit Pistons,99,Los Angeles Lakers,106,-7,-4.22,7.75
35,Indiana Pacers,115,Charlotte Hornets,104,11,1.61,-6.88
36,Brooklyn Nets,89,Orlando Magic,101,-12,-1.18,-0.85
37,Oklahoma City Thunder,113,Philadelphia 76ers,120,-7,2.79,2.22
38,Boston Celtics,94,Washington Wizards,99,-5,5.69,-4.86
39,Denver Nuggets,123,Atlanta Hawks,115,8,3.02,-7.57
40,Utah Jazz,128,New Orleans Pelicans,126,2,3.2,0.3
41,Chicago Bulls,110,Dallas Mavericks,118,-8,-3.81,5.84
42,Milwaukee Bucks,104,San Antonio Spurs,126,-22,10.44,-1.19
43,Golden State Warriors,98,Sacramento Kings,111,-13,-7.92,-1.44
44,Detroit Pistons,115,Cleveland Cavaliers,113,2,-4.22,-7.57
45,Portland Trail Blazers,101,Toronto Raptors,99,2,-1.11,5.88
46,Oklahoma City Thunder,111,Brooklyn Nets,103,8,2.79,-1.18
47,Minnesota Timberwolves,112,Memphis Grizzlies,119,-7,-3.78,-1.05
48,Sacramento Kings,114,Phoenix Suns,103,11,-1.44,-1.04
49,New York Knicks,87,Los Angeles Lakers,117,-30,-6.55,7.75
50,San Antonio Spurs,129,Boston Celtics,114,15,-1.19,5.69
51,Toronto Raptors,112,Charlotte Hornets,110,2,5.88,-6.88
52,Miami Heat,122,Indiana Pacers,108,14,2.58,1.61
53,Washington Wizards,89,Orlando Magic,123,-34,-4.86,-0.85
54,Houston Rockets,122,Atlanta Hawks,115,7,3.78,-7.57
55,Denver Nuggets,107,Dallas Mavericks,106,1,3.02,5.84
56,Chicago Bulls,108,New Orleans Pelicans,123,-15,-3.81,0.3
57,New York Knicks,104,Utah Jazz,128,-24,-6.55,3.2
58,Milwaukee Bucks,107,Golden State Warriors,98,9,10.44,-7.92
59,Cleveland Cavaliers,115,Detroit Pistons,112,3,-7.57,-4.22
60,Boston Celtics,98,Philadelphia 76ers,109,-11,5.69,2.22
61,Portland Trail Blazers,102,Minnesota Timberwolves,116,-14,-1.11,-3.78
62,Houston Rockets,92,Oklahoma City Thunder,113,-21,3.78,2.79
63,Atlanta Hawks,101,Washington Wizards,111,-10,-7.57,-4.86
64,New Orleans Pelicans,123,New York Knicks,111,12,0.3,-6.55
65,Miami Heat,113,Brooklyn Nets,117,-4,2.58,-1.18
66,Indiana Pacers,116,Chicago Bulls,105,11,1.61,-3.81
67,San Antonio Spurs,121,Memphis Grizzlies,134,-13,-1.19,-1.05
68,Orlando Magic,94,Phoenix Suns,98,-4,-0.85,-1.04
69,Charlotte Hornets,92,Utah Jazz,109,-17,-6.88,3.2
70,Los Angeles Lakers,129,Dallas Mavericks,114,15,7.75,5.84
71,Milwaukee Bucks,127,Sacramento Kings,106,21,10.44,-1.44
72,Golden State Warriors,100,Los Angeles Clippers,109,-9,-7.92,6.74
73,Minnesota Timberwolves,109,Houston Rockets,139,-30,-3.78,3.78
74,New Orleans Pelicans,105,Boston Celtics,140,-35,0.3,5.69
75,Chicago Bulls,108,Detroit Pistons,99,9,-3.81,-4.22
76,Los Angeles Lakers,125,Oklahoma City Thunder,110,15,7.75,2.79
77,Philadelphia 76ers,91,Dallas Mavericks,109,-18,2.22,5.84
78,Cleveland Cavaliers,111,Denver Nuggets,103,8,-7.57,3.02
79,Milwaukee Bucks,122,Portland Trail Blazers,101,21,10.44,-1.11
80,Miami Heat,121,New York Knicks,124,-3,2.58,-6.55
81,Utah Jazz,127,Washington Wizards,116,11,3.2,-4.86
82,Atlanta Hawks,86,Brooklyn Nets,108,-22,-7.57,-1.18
83,Golden State Warriors,102,Memphis Grizzlies,122,-20,-7.92,-1.05
84,San Antonio Spurs,105,Toronto Raptors,104,1,-1.19,5.88
85,Los Angeles Clippers,104,Denver Nuggets,114,-10,6.74,3.02
86,Charlotte Hornets,92,Phoenix Suns,100,-8,-6.88,-1.04
87,New Orleans Pelicans,117,Detroit Pistons,110,7,0.3,-4.22
88,Philadelphia 76ers,95,Indiana Pacers,101,-6,2.22,1.61
89,Chicago Bulls,101,Boston Celtics,113,-12,-3.81,5.69
90,Oklahoma City Thunder,117,Minnesota Timberwolves,104,13,2.79,-3.78
91,Charlotte Hornets,112,Portland Trail Blazers,115,-3,-6.88,-1.11
92,Orlando Magic,114,Sacramento Kings,112,2,-0.85,-1.44
93,Cleveland Cavaliers,99,Los Angeles Lakers,128,-29,-7.57,7.75
94,Phoenix Suns,110,Atlanta Hawks,123,-13,-1.04,-7.57
95,Utah Jazz,118,Brooklyn Nets,107,11,3.2,-1.18
96,Houston Rockets,110,Memphis Grizzlies,121,-11,3.78,-1.05
97,New York Knicks,102,Milwaukee Bucks,128,-26,-6.55,10.44
98,Dallas Mavericks,124,Golden State Warriors,97,27,5.84,-7.92
99,Cleveland Cavaliers,103,Los Angeles Clippers,128,-25,-7.57,6.74
100,Detroit Pistons,116,Boston Celtics,103,13,-4.22,5.69
101,Brooklyn Nets,106,Philadelphia 76ers,117,-11,-1.18,2.22
102,San Antonio Spurs,100,Miami Heat,106,-6,-1.19,2.58
103,Washington Wizards,106,Chicago Bulls,115,-9,-4.86,-3.81
104,Indiana Pacers,104,Minnesota Timberwolves,99,5,1.61,-3.78
105,Toronto Raptors,130,Oklahoma City Thunder,121,9,5.88,2.79
106,Charlotte Hornets,86,Denver Nuggets,100,-14,-6.88,3.02
107,Portland Trail Blazers,117,Houston Rockets,107,10,-1.11,3.78
108,Dallas Mavericks,127,Sacramento Kings,123,4,5.84,-1.44
109,Orlando Magic,119,Los Angeles Lakers,118,1,-0.85,7.75
110,Phoenix Suns,121,New York Knicks,98,23,-1.04,-6.55
111,Boston Celtics,123,Milwaukee Bucks,128,-5,5.69,10.44
112,Utah Jazz,132,New Orleans Pelicans,138,-6,3.2,0.3
113,Denver Nuggets,134,Golden State Warriors,131,3,3.02,-7.92
114,Orlando Magic,95,Los Angeles Clippers,122,-27,-0.85,6.74
115,Minnesota Timberwolves,114,Indiana Pacers,116,-2,-3.78,1.61
116,Chicago Bulls,89,Philadelphia 76ers,100,-11,-3.81,2.22
117,Washington Wizards,111,Toronto Raptors,140,-29,-4.86,5.88
118,Cleveland Cavaliers,109,Memphis Grizzlies,113,-4,-7.57,-1.05
119,Miami Heat,115,Oklahoma City Thunder,108,7,2.58,2.79
120,Atlanta Hawks,121,San Antonio Spurs,120,1,-7.57,-1.19
121,Portland Trail Blazers,112,Dallas Mavericks,120,-8,-1.11,5.84
122,Los Angeles Clippers,133,New Orleans Pelicans,130,3,6.74,0.3
123,Milwaukee Bucks,117,Brooklyn Nets,97,20,10.44,-1.18
124,Phoenix Suns,123,Boston Celtics,119,4,-1.04,5.69
125,Detroit Pistons,136,Atlanta Hawks,103,33,-4.22,-7.57
126,Philadelphia 76ers,90,New York Knicks,87,3,2.22,-6.55
127,Cleveland Cavaliers,116,Chicago Bulls,118,-2,-7.57,-3.81
128,Toronto Raptors,122,Minnesota Timberwolves,112,10,5.88,-3.78
129,Orlando Magic,95,Golden State Warriors,109,-14,-0.85,-7.92
130,Los Angeles Lakers,124,Houston Rockets,115,9,7.75,3.78
131,Portland Trail Blazers,106,Oklahoma City Thunder,119,-13,-1.11,2.79
132,Sacramento Kings,101,Utah Jazz,123,-22,-1.44,3.2
133,Miami Heat,102,San Antonio Spurs,107,-5,2.58,-1.19
134,Indiana Pacers,115,Denver Nuggets,107,8,1.61,3.02
135,Detroit Pistons,100,Washington Wizards,106,-6,-4.22,-4.86
136,Toronto Raptors,122,Atlanta Hawks,117,5,5.88,-7.57
137,Philadelphia 76ers,117,Brooklyn Nets,111,6,2.22,-1.18
138,Orlando Magic,106,Charlotte Hornets,83,23,-0.85,-6.88
139,New York Knicks,106,Cleveland Cavaliers,86,20,-6.55,-7.57
140,Oklahoma City Thunder,112,Houston Rockets,107,5,2.79,3.78
141,New Orleans Pelicans,126,Memphis Grizzlies,116,10,0.3,-1.05
142,Sacramento Kings,113,Miami Heat,118,-5,-1.44,2.58
143,Chicago Bulls,98,Milwaukee Bucks,111,-13,-3.81,10.44
144,Los Angeles Lakers,107,Boston Celtics,139,-32,7.75,5.69
145,Denver Nuggets,107,Minnesota Timberwolves,100,7,3.02,-3.78
146,San Antonio Spurs,120,Phoenix Suns,118,2,-1.19,-1.04
147,Indiana Pacers,88,Utah Jazz,118,-30,1.61,3.2
148,Golden State Warriors,124,Portland Trail Blazers,129,-5,-7.92,-1.11
149,Los Angeles Clippers,110,Dallas Mavericks,107,3,6.74,5.84
150,Sacramento Kings,106,Detroit Pistons,127,-21,-1.44,-4.22
151,Oklahoma City Thunder,120,Orlando Magic,114,6,2.79,-0.85
152,Philadelphia 76ers,95,Toronto Raptors,107,-12,2.22,5.88
153,Los Angeles Clippers,95,Atlanta Hawks,102,-7,6.74,-7.57
154,Memphis Grizzlies,95,Boston Celtics,119,-24,-1.05,5.69
155,Washington Wizards,129,Miami Heat,134,-5,-4.86,2.58
156,Los Angeles Lakers,100,New York Knicks,92,8,7.75,-6.55
157,Minnesota Timberwolves,110,Chicago Bulls,117,-7,-3.78,-3.81
158,Denver Nuggets,105,Houston Rockets,121,-16,3.02,3.78
159,Indiana Pacers,112,Phoenix Suns,87,25,1.61,-1.04
160,San Antonio Spurs,121,New Orleans Pelicans,117,4,-1.19,0.3
161,Utah Jazz,129,Golden State Warriors,96,33,3.2,-7.92
162,Washington Wizards,124,Cleveland Cavaliers,112,12,-4.86,-7.57
163,Los Angeles Lakers,128,Brooklyn Nets,113,15,7.75,-1.18
164,Dallas Mavericks,133,Portland Trail Blazers,125,8,5.84,-1.11
165,Milwaukee Bucks,116,Charlotte Hornets,103,13,10.44,-6.88
166,Memphis Grizzlies,125,Detroit Pistons,112,13,-1.05,-4.22
167,Boston Celtics,109,Orlando Magic,98,11,5.69,-0.85
168,Toronto Raptors,118,New York Knicks,112,6,5.88,-6.55
169,Sacramento Kings,98,Chicago Bulls,81,17,-1.44,-3.81
170,Los Angeles Clippers,122,Miami Heat,117,5,6.74,2.58
171,Houston Rockets,131,Minnesota Timberwolves,124,7,3.78,-3.78
172,Denver Nuggets,113,New Orleans Pelicans,106,7,3.02,0.3
173,Atlanta Hawks,111,Oklahoma City Thunder,140,-29,-7.57,2.79
174,Phoenix Suns,103,San Antonio Spurs,99,4,-1.04,-1.19
175,Indiana Pacers,129,Golden State Warriors,118,11,1.61,-7.92
176,Dallas Mavericks,107,Utah Jazz,112,-5,5.84,3.2
177,Brooklyn Nets,121,Detroit Pistons,111,10,-1.18,-4.22
178,Chicago Bulls,118,Cleveland Cavaliers,106,12,-3.81,-7.57
179,Oklahoma City Thunder,113,Minnesota Timberwolves,104,9,2.79,-3.78
180,Los Angeles Lakers,91,Philadelphia 76ers,108,-17,7.75,2.22
181,Houston Rockets,110,Denver Nuggets,117,-7,3.78,3.02
182,Toronto Raptors,110,San Antonio Spurs,106,4,5.88,-1.19
183,Washington Wizards,133,Atlanta Hawks,152,-19,-4.86,-7.57
184,Phoenix Suns,109,Memphis Grizzlies,114,-5,-1.04,-1.05
185,Boston Celtics,108,New Orleans Pelicans,123,-15,5.69,0.3
186,Brooklyn Nets,97,New York Knicks,110,-13,-1.18,-6.55
187,Los Angeles Clippers,112,Orlando Magic,97,15,6.74,-0.85
188,Indiana Pacers,129,Portland Trail Blazers,139,-10,1.61,-1.11
189,Cleveland Cavaliers,115,Detroit Pistons,100,15,-7.57,-4.22
190,Orlando Magic,92,Miami Heat,113,-21,-0.85,2.58
191,San Antonio Spurs,109,Chicago Bulls,110,-1,-1.19,-3.81
192,Sacramento Kings,133,Minnesota Timberwolves,129,4,-1.44,-3.78
193,Dallas Mavericks,107,Oklahoma City Thunder,97,10,5.84,2.79
194,Houston Rockets,126,Utah Jazz,117,9,3.78,3.2
195,New York Knicks,92,Charlotte Hornets,97,-5,-6.55,-6.88
196,Golden State Warriors,104,Philadelphia 76ers,115,-11,-7.92,2.22
197,New Orleans Pelicans,125,Cleveland Cavaliers,111,14,0.3,-7.57
198,Atlanta Hawks,114,Toronto Raptors,130,-16,-7.57,5.88
199,Denver Nuggets,96,Memphis Grizzlies,104,-8,3.02,-1.05
200,Boston Celtics,109,Miami Heat,101,8,5.69,2.58
201,Washington Wizards,131,Milwaukee Bucks,151,-20,-4.86,10.44
202,Phoenix Suns,133,Dallas Mavericks,104,29,-1.04,5.84
203,Chicago Bulls,106,Indiana Pacers,115,-9,-3.81,1.61
204,Detroit Pistons,115,Brooklyn Nets,125,-10,-4.22,-1.18
205,Memphis Grizzlies,127,New York Knicks,106,21,-1.05,-6.55
206,Utah Jazz,120,San Antonio Spurs,127,-7,3.2,-1.19
207,Houston Rockets,112,Portland Trail Blazers,125,-13,3.78,-1.11
208,Oklahoma City Thunder,120,Sacramento Kings,100,20,2.79,-1.44
209,Toronto Raptors,115,Cleveland Cavaliers,109,6,5.88,-7.57
210,Charlotte Hornets,107,Washington Wizards,121,-14,-6.88,-4.86
211,Philadelphia 76ers,117,Atlanta Hawks,127,-10,2.22,-7.57
212,Golden State Warriors,104,Boston Celtics,119,-15,-7.92,5.69
213,Utah Jazz,100,Denver Nuggets,106,-6,3.2,3.02
214,Sacramento Kings,124,Los Angeles Clippers,103,21,-1.44,6.74
215,Toronto Raptors,105,Detroit Pistons,92,13,5.88,-4.22
216,Chicago Bulls,118,Brooklyn Nets,133,-15,-3.81,-1.18
217,Dallas Mavericks,121,Houston Rockets,128,-7,5.84,3.78
218,Memphis Grizzlies,111,New Orleans Pelicans,139,-28,-1.05,0.3
219,Denver Nuggets,127,Milwaukee Bucks,115,12,3.02,10.44
220,Oklahoma City Thunder,111,Phoenix Suns,107,4,2.79,-1.04
221,Portland Trail Blazers,127,Los Angeles Lakers,119,8,-1.11,7.75
0,Minnesota Timberwolves,106,Los Angeles Clippers,118,-12,-3.78,6.74
1,New York Knicks,92,Indiana Pacers,85,7,-6.55,1.61
2,Miami Heat,102,Orlando Magic,89,13,2.58,-0.85
3,Golden State Warriors,131,Cleveland Cavaliers,112,19,-7.92,-7.57
4,Brooklyn Nets,107,Washington Wizards,113,-6,-1.18,-4.86
5,Philadelphia 76ers,95,Boston Celtics,116,-21,2.22,5.69
6,Atlanta Hawks,100,Dallas Mavericks,123,-23,-7.57,5.84
7,Charlotte Hornets,90,San Antonio Spurs,114,-24,-6.88,-1.19
8,Los Angeles Lakers,129,Sacramento Kings,113,16,7.75,-1.44
9,Utah Jazz,107,Portland Trail Blazers,124,-17,3.2,-1.11
10,Denver Nuggets,123,Detroit Pistons,128,-5,3.02,-4.22
11,New Orleans Pelicans,109,Houston Rockets,117,-8,0.3,3.78
12,Phoenix Suns,108,Milwaukee Bucks,129,-21,-1.04,10.44
13,Chicago Bulls,102,Toronto Raptors,129,-27,-3.81,5.88
14,Orlando Magic,112,Charlotte Hornets,100,12,-0.85,-6.88
15,New York Knicks,139,Cleveland Cavaliers,134,5,-6.55,-7.57
16,Dallas Mavericks,112,Indiana Pacers,103,9,5.84,1.61
17,Golden State Warriors,125,Washington Wizards,117,8,-7.92,-4.86
18,Boston Celtics,123,Atlanta Hawks,115,8,5.69,-7.57
19,Phoenix Suns,97,Brooklyn Nets,119,-22,-1.04,-1.18
20,Philadelphia 76ers,106,Miami Heat,137,-31,2.22,2.58
21,Detroit Pistons,82,Memphis Grizzlies,96,-14,-4.22,-1.05
22,Minnesota Timberwolves,109,Sacramento Kings,113,-4,-3.78,-1.44
23,San Antonio Spurs,105,Los Angeles Clippers,108,-3,-1.19,6.74
24,Milwaukee Bucks,120,New Orleans Pelicans,108,12,10.44,0.3
25,Charlotte Hornets,110,Houston Rockets,125,-15,-6.88,3.78
26,Portland Trail Blazers,99,Denver Nuggets,127,-28,-1.11,3.02
27,San Antonio Spurs,102,Los Angeles Lakers,129,-27,-1.19,7.75
28,Phoenix Suns,108,Detroit Pistons,116,-8,-1.04,-4.22
29,Orlando Magic,100,Boston Celtics,116,-16,-0.85,5.69
30,Golden State Warriors,88,Brooklyn Nets,129,-41,-7.92,-1.18
31,Indiana Pacers,118,Toronto Raptors,119,-1,1.61,5.88
32,Atlanta Hawks,127,Minnesota Timberwolves,120,7,-7.57,-3.78
33,Cleveland Cavaliers,103,Oklahoma City Thunder,109,-6,-7.57,2.79
34,Memphis Grizzlies,121,Dallas Mavericks,107,14,-1.05,5.84
35,Denver Nuggets,98,Utah Jazz,95,3,3.02,3.2
36,Miami Heat,111,Los Angeles Clippers,128,-17,2.58,6.74
37,Orlando Magic,103,New York Knicks,105,-2,-0.85,-6.55
38,New Orleans Pelicans,125,Chicago Bulls,119,6,0.3,-3.81
39,Philadelphia 76ers,101,Milwaukee Bucks,112,-11,2.22,10.44
40,San Antonio Spurs,117,Portland Trail Blazers,125,-8,-1.19,-1.11
41,Houston Rockets,121,Los Angeles Lakers,111,10,3.78,7.75
42,Memphis Grizzlies,107,Philadelphia 76ers,119,-12,-1.05,2.22
43,Dallas Mavericks,118,Washington Wizards,119,-1,5.84,-4.86
44,Atlanta Hawks,107,Boston Celtics,112,-5,-7.57,5.69
45,Toronto Raptors,115,Indiana Pacers,106,9,5.88,1.61
46,Detroit Pistons,101,Oklahoma City Thunder,108,-7,-4.22,2.79
47,Houston Rockets,91,Phoenix Suns,127,-36,3.78,-1.04
48,Miami Heat,97,Sacramento Kings,105,-8,2.58,-1.44
49,Portland Trail Blazers,114,Utah Jazz,117,-3,-1.11,3.2
50,Milwaukee Bucks,111,Orlando Magic,95,16,10.44,-0.85
51,Dallas Mavericks,116,Charlotte Hornets,100,16,5.84,-6.88
52,New York Knicks,95,Detroit Pistons,92,3,-6.55,-4.22
53,New Orleans Pelicans,124,Indiana Pacers,117,7,0.3,1.61
54,Brooklyn Nets,118,Toronto Raptors,119,-1,-1.18,5.88
55,Los Angeles Clippers,115,Minnesota Timberwolves,142,-27,6.74,-3.78
56,Los Angeles Lakers,125,Golden State Warriors,120,5,7.75,-7.92
57,Denver Nuggets,117,Phoenix Suns,108,9,3.02,-1.04
58,San Antonio Spurs,102,Sacramento Kings,122,-20,-1.19,-1.44
59,Boston Celtics,112,Oklahoma City Thunder,111,1,5.69,2.79
60,New York Knicks,135,Atlanta Hawks,140,-5,-6.55,-7.57
61,Chicago Bulls,111,Philadelphia 76ers,118,-7,-3.81,2.22
62,Memphis Grizzlies,106,Washington Wizards,99,7,-1.05,-4.86
63,Utah Jazz,114,Houston Rockets,113,1,3.2,3.78
64,Los Angeles Clippers,133,Cleveland Cavaliers,92,41,6.74,-7.57
65,Miami Heat,109,Portland Trail Blazers,115,-6,2.58,-1.11
66,Charlotte Hornets,87,Detroit Pistons,76,11,-6.88,-4.22
67,Brooklyn Nets,106,Indiana Pacers,105,1,-1.18,1.61
68,Atlanta Hawks,126,Orlando Magic,135,-9,-7.57,-0.85
69,Minnesota Timberwolves,126,Toronto Raptors,137,-11,-3.78,5.88
70,Sacramento Kings,111,Milwaukee Bucks,123,-12,-1.44,10.44
71,Utah Jazz,123,Dallas Mavericks,119,4,3.2,5.84
72,San Antonio Spurs,120,Denver Nuggets,127,-7,-1.19,3.02
73,Miami Heat,113,Golden State Warriors,101,12,2.58,-7.92
74,Phoenix Suns,100,Los Angeles Lakers,125,-25,-1.04,7.75
75,Los Angeles Clippers,103,Philadelphia 76ers,110,-7,6.74,2.22
76,Chicago Bulls,114,Washington Wizards,126,-12,-3.81,-4.86
77,Portland Trail Blazers,117,New Orleans Pelicans,138,-21,-1.11,0.3
78,San Antonio Spurs,114,Oklahoma City Thunder,106,8,-1.19,2.79
79,Boston Celtics,105,Houston Rockets,116,-11,5.69,3.78
80,Atlanta Hawks,105,Cleveland Cavaliers,127,-22,-7.57,-7.57
81,Detroit Pistons,112,Orlando Magic,116,-4,-4.22,-0.85
82,Toronto Raptors,91,Brooklyn Nets,101,-10,5.88,-1.18
83,Milwaukee Bucks,111,Indiana Pacers,118,-7,10.44,1.61
84,Washington Wizards,114,New York Knicks,96,18,-4.86,-6.55
85,Portland Trail Blazers,104,Memphis Grizzlies,111,-7,-1.11,-1.05
86,Charlotte Hornets,115,Minnesota Timberwolves,108,7,-6.88,-3.78
87,Sacramento Kings,111,Dallas Mavericks,130,-19,-1.44,5.84
88,Golden State Warriors,106,Phoenix Suns,112,-6,-7.92,-1.04
89,Miami Heat,101,Utah Jazz,116,-15,2.58,3.2
90,Los Angeles Lakers,120,Denver Nuggets,116,4,7.75,3.02
91,Los Angeles Clippers,133,Boston Celtics,141,-8,6.74,5.69
92,Oklahoma City Thunder,123,New Orleans Pelicans,118,5,2.79,0.3
93,Milwaukee Bucks,126,Detroit Pistons,106,20,10.44,-4.22
94,Miami Heat,124,Atlanta Hawks,129,-5,2.58,-7.57
95,Charlotte Hornets,103,Chicago Bulls,93,10,-6.88,-3.81
96,Brooklyn Nets,104,Philadelphia 76ers,112,-8,-1.18,2.22
97,Memphis Grizzlies,125,Sacramento Kings,129,-4,-1.05,-1.44
98,Houston Rockets,135,Golden State Warriors,105,30,3.78,-7.92
99,Dallas Mavericks,122,Orlando Magic,106,16,5.84,-0.85
100,Cleveland Cavaliers,113,Washington Wizards,108,5,-7.57,-4.86
101,Indiana Pacers,106,New York Knicks,98,8,1.61,-6.55
102,Phoenix Suns,101,Toronto Raptors,118,-17,-1.04,5.88
103,Boston Celtics,127,Minnesota Timberwolves,117,10,5.69,-3.78
104,Denver Nuggets,101,Oklahoma City Thunder,113,-12,3.02,2.79
105,San Antonio Spurs,113,Utah Jazz,104,9,-1.19,3.2
106,Memphis Grizzlies,105,Los Angeles Lakers,117,-12,-1.05,7.75
107,New Orleans Pelicans,128,Portland Trail Blazers,115,13,0.3,-1.11
108,Sacramento Kings,112,Los Angeles Clippers,103,9,-1.44,6.74
109,Brooklyn Nets,115,Charlotte Hornets,86,29,-1.18,-6.88
110,Dallas Mavericks,107,Atlanta Hawks,111,-4,5.84,-7.57
111,Phoenix Suns,112,Chicago Bulls,104,8,-1.04,-3.81
112,Cleveland Cavaliers,105,Miami Heat,124,-19,-7.57,2.58
113,Philadelphia 76ers,98,Milwaukee Bucks,119,-21,2.22,10.44
114,Houston Rockets,120,Utah Jazz,110,10,3.78,3.2
115,Boston Celtics,112,Los Angeles Lakers,114,-2,5.69,7.75
116,Minnesota Timberwolves,116,Denver Nuggets,128,-12,-3.78,3.02
117,Indiana Pacers,81,Toronto Raptors,127,-46,1.61,5.88
118,Washington Wizards,117,Chicago Bulls,126,-9,-4.86,-3.81
119,San Antonio Spurs,103,Oklahoma City Thunder,131,-28,-1.19,2.79
120,New Orleans Pelicans,115,Golden State Warriors,101,14,0.3,-7.92
121,Detroit Pistons,104,Portland Trail Blazers,107,-3,-4.22,-1.11
122,Miami Heat,119,Cleveland Cavaliers,125,-6,2.58,-7.57
123,Atlanta Hawks,112,Philadelphia 76ers,129,-17,-7.57,2.22
124,Milwaukee Bucks,137,Washington Wizards,134,3,10.44,-4.86
125,Orlando Magic,115,Brooklyn Nets,113,2,-0.85,-1.18
126,New York Knicks,112,Houston Rockets,123,-11,-6.55,3.78
127,Minnesota Timberwolves,123,Dallas Mavericks,139,-16,-3.78,5.84
128,Phoenix Suns,131,Utah Jazz,111,20,-1.04,3.2
129,Memphis Grizzlies,97,Los Angeles Clippers,124,-27,-1.05,6.74
130,Charlotte Hornets,80,Indiana Pacers,119,-39,-6.88,1.61
131,Milwaukee Bucks,108,Toronto Raptors,97,11,10.44,5.88
132,Oklahoma City Thunder,124,Chicago Bulls,122,2,2.79,-3.81
133,Detroit Pistons,98,Denver Nuggets,115,-17,-4.22,3.02
134,New Orleans Pelicans,109,Los Angeles Lakers,118,-9,0.3,7.75
135,Boston Celtics,118,Portland Trail Blazers,106,12,5.69,-1.11
136,Sacramento Kings,112,Golden State Warriors,94,18,-1.44,-7.92
137,New York Knicks,101,Charlotte Hornets,107,-6,-6.55,-6.88
138,Philadelphia 76ers,94,Cleveland Cavaliers,108,-14,2.22,-7.57
139,Brooklyn Nets,106,Washington Wizards,110,-4,-1.18,-4.86
140,Orlando Magic,130,Atlanta Hawks,120,10,-0.85,-7.57
141,Minnesota Timberwolves,129,Miami Heat,126,3,-3.78,2.58
142,Memphis Grizzlies,112,Houston Rockets,140,-28,-1.05,3.78
143,Dallas Mavericks,109,San Antonio Spurs,103,6,5.84,-1.19
144,Los Angeles Clippers,102,Phoenix Suns,92,10,6.74,-1.04
145,Boston Celtics,114,Utah Jazz,103,11,5.69,3.2
146,New York Knicks,106,Philadelphia 76ers,115,-9,-6.55,2.22
147,Portland Trail Blazers,100,Indiana Pacers,106,-6,-1.11,1.61
148,Sacramento Kings,108,Oklahoma City Thunder,112,-4,-1.44,2.79
149,Los Angeles Lakers,116,Golden State Warriors,86,30,7.75,-7.92
150,Minnesota Timberwolves,125,Orlando Magic,136,-11,-3.78,-0.85
151,Brooklyn Nets,118,Atlanta Hawks,141,-23,-1.18,-7.57
152,Charlotte Hornets,99,Toronto Raptors,96,3,-6.88,5.88
153,Sacramento Kings,104,Memphis Grizzlies,101,3,-1.44,-1.05
154,Dallas Mavericks,118,Miami Heat,126,-8,5.84,2.58
155,Oklahoma City Thunder,86,Milwaukee Bucks,133,-47,2.79,10.44
156,Cleveland Cavaliers,104,New Orleans Pelicans,116,-12,-7.57,0.3
157,Detroit Pistons,113,Phoenix Suns,111,2,-4.22,-1.04
158,Washington Wizards,119,Utah Jazz,129,-10,-4.86,3.2
159,Denver Nuggets,103,Los Angeles Clippers,132,-29,3.02,6.74
160,Chicago Bulls,115,New York Knicks,125,-10,-3.81,-6.55
161,Portland Trail Blazers,117,Atlanta Hawks,129,-12,-1.11,-7.57
162,Brooklyn Nets,113,Miami Heat,116,-3,-1.18,2.58
163,Indiana Pacers,113,Cleveland Cavaliers,104,9,1.61,-7.57
164,Los Angeles Lakers,88,Memphis Grizzlies,105,-17,7.75,-1.05
165,Houston Rockets,111,Boston Celtics,110,1,3.78,5.69
166,Orlando Magic,113,San Antonio Spurs,114,-1,-0.85,-1.19
167,Golden State Warriors,115,Phoenix Suns,99,16,-7.92,-1.04
0,Milwaukee Bucks,93,Charlotte Hornets,85,8,10.44,-6.88
1,Philadelphia 76ers,130,Los Angeles Clippers,136,-6,2.22,6.74
2,Dallas Mavericks,111,Minnesota Timberwolves,91,20,5.84,-3.78
3,Toronto Raptors,118,Denver Nuggets,133,-15,5.88,3.02
4,Detroit Pistons,100,Sacramento Kings,106,-6,-4.22,-1.44
5,Los Angeles Lakers,122,New Orleans Pelicans,114,8,7.75,0.3
6,Washington Wizards,124,Golden State Warriors,110,14,-4.86,-7.92
7,Utah Jazz,126,Cleveland Cavaliers,113,13,3.2,-7.57
8,Houston Rockets,123,New York Knicks,125,-2,3.78,-6.55
9,Portland Trail Blazers,130,Orlando Magic,107,23,-1.11,-0.85
10,Memphis Grizzlies,127,Atlanta Hawks,88,39,-1.05,-7.57
11,Milwaukee Bucks,89,Miami Heat,105,-16,10.44,2.58
12,Dallas Mavericks,107,Chicago Bulls,109,-2,5.84,-3.81
13,Indiana Pacers,116,San Antonio Spurs,111,5,1.61,-1.19
14,San Antonio Spurs,104,Charlotte Hornets,103,1,-1.19,-6.88
15,Brooklyn Nets,129,Boston Celtics,120,9,-1.18,5.69
16,Minnesota Timberwolves,139,New Orleans Pelicans,134,5,-3.78,0.3
17,Los Angeles Clippers,109,Oklahoma City Thunder,94,15,6.74,2.79
18,Golden State Warriors,116,Denver Nuggets,100,16,-7.92,3.02
19,Toronto Raptors,123,Phoenix Suns,114,9,5.88,-1.04
20,Philadelphia 76ers,107,Los Angeles Lakers,120,-13,2.22,7.75
21,Washington Wizards,126,Sacramento Kings,133,-7,-4.86,-1.44
22,Boston Celtics,112,Cleveland Cavaliers,106,6,5.69,-7.57
23,Oklahoma City Thunder,114,Detroit Pistons,107,7,2.79,-4.22
24,Indiana Pacers,100,Milwaukee Bucks,119,-19,1.61,10.44
25,Memphis Grizzlies,118,Brooklyn Nets,79,39,-1.05,-1.18
26,Utah Jazz,112,New York Knicks,104,8,3.2,-6.55
27,Orlando Magic,113,Miami Heat,116,-3,-0.85,2.58
28,Chicago Bulls,108,Minnesota Timberwolves,115,-7,-3.81,-3.78
29,New Orleans Pelicans,123,Dallas Mavericks,127,-4,0.3,5.84
30,Washington Wizards,104,Portland Trail Blazers,125,-21,-4.86,-1.11
31,Denver Nuggets,114,Charlotte Hornets,112,2,3.02,-6.88
32,Los Angeles Clippers,120,Houston Rockets,105,15,6.74,3.78
33,Philadelphia 76ers,125,Sacramento Kings,108,17,2.22,-1.44
34,Toronto Raptors,121,Golden State Warriors,113,8,5.88,-7.92
35,Atlanta Hawks,112,Washington Wizards,118,-6,-7.57,-4.86
36,San Antonio Spurs,120,Brooklyn Nets,139,-19,-1.19,-1.18
37,Oklahoma City Thunder,126,New York Knicks,103,23,2.79,-6.55
38,Indiana Pacers,108,Chicago Bulls,102,6,1.61,-3.81
39,Orlando Magic,132,Minnesota Timberwolves,118,14,-0.85,-3.78
40,Miami Heat,104,New Orleans Pelicans,110,-6,2.58,0.3
41,Utah Jazz,99,Boston Celtics,94,5,3.2,5.69
42,Memphis Grizzlies,96,Dallas Mavericks,121,-25,-1.05,5.84
43,Portland Trail Blazers,117,Phoenix Suns,127,-10,-1.11,-1.04
44,Milwaukee Bucks,103,Los Angeles Lakers,113,-10,10.44,7.75
45,Houston Rockets,99,Charlotte Hornets,108,-9,3.78,-6.88
46,Utah Jazz,111,Detroit Pistons,105,6,3.2,-4.22
47,Denver Nuggets,102,Cleveland Cavaliers,104,-2,3.02,-7.57
48,Atlanta Hawks,101,Memphis Grizzlies,118,-17,-7.57,-1.05
49,Philadelphia 76ers,114,Golden State Warriors,118,-4,2.22,-7.92
50,Sacramento Kings,123,Portland Trail Blazers,111,12,-1.44,-1.11
51,Chicago Bulls,107,Brooklyn Nets,110,-3,-3.81,-1.18
52,New Orleans Pelicans,120,Minnesota Timberwolves,107,13,0.3,-3.78
53,Los Angeles Lakers,112,Los Angeles Clippers,103,9,7.75,6.74
54,Oklahoma City Thunder,105,Boston Celtics,104,1,2.79,5.69
55,Milwaukee Bucks,131,Phoenix Suns,140,-9,10.44,-1.04
56,Miami Heat,100,Washington Wizards,89,11,2.58,-4.86
57,Indiana Pacers,112,Dallas Mavericks,109,3,1.61,5.84
58,Orlando Magic,126,Houston Rockets,106,20,-0.85,3.78
59,Detroit Pistons,84,New York Knicks,96,-12,-4.22,-6.55
60,San Antonio Spurs,129,Cleveland Cavaliers,132,-3,-1.19,-7.57
61,Toronto Raptors,118,Sacramento Kings,113,5,5.88,-1.44
62,Charlotte Hornets,138,Atlanta Hawks,143,-5,-6.88,-7.57
63,Milwaukee Bucks,95,Denver Nuggets,109,-14,10.44,3.02
64,Toronto Raptors,101,Utah Jazz,92,9,5.88,3.2
65,New York Knicks,115,Washington Wizards,122,-7,-6.55,-4.86
66,Boston Celtics,114,Indiana Pacers,111,3,5.69,1.61
67,Minnesota Timberwolves,111,Houston Rockets,117,-6,-3.78,3.78
68,Dallas Mavericks,109,San Antonio Spurs,119,-10,5.84,-1.19
69,Orlando Magic,120,Memphis Grizzlies,115,5,-0.85,-1.05
70,Cleveland Cavaliers,103,Chicago Bulls,108,-5,-7.57,-3.81
71,Phoenix Suns,105,Portland Trail Blazers,121,-16,-1.04,-1.11
72,Brooklyn Nets,104,Los Angeles Lakers,102,2,-1.18,7.75
73,Los Angeles Clippers,131,Golden State Warriors,107,24,6.74,-7.92
74,Detroit Pistons,106,Philadelphia 76ers,124,-18,-4.22,2.22
75,New York Knicks,136,Atlanta Hawks,131,5,-6.55,-7.57
76,Charlotte Hornets,109,Miami Heat,98,11,-6.88,2.58
77,Denver Nuggets,97,Dallas Mavericks,113,-16,3.02,5.84
